390
445
55

7
9
3

0 0 0 0 1 0 0
0 0 0 0 1 0 0
0 0 0 0 0 0 0
0 1 1 1 0 0 0
0 0 0 0 1 0 0
0 0 0 0 1 0 0
0 1 1 1 1 1 1
1 1 0 0 1 0 0
0 0 0 0 1 0 0

0 0 0 0 1 0 0
0 0 0 0 1 0 0
0 0 0 0 0 0 0
0 1 1 1 0 0 0
0 0 0 0 1 0 0
0 0 0 0 0 0 0
0 1 1 0 1 1 0
1 1 0 0 1 0 0
0 0 0 0 1 0 0

0 0 0 0 1 0 0
0 0 0 0 1 0 0
0 0 0 0 0 0 0
0 1 1 1 0 0 0
0 0 0 0 1 0 0
0 0 0 0 1 0 0
0 1 1 1 1 0 1
1 1 0 0 1 0 0
1 1 0 0 1 0 0
